{
  "width": 31,
  "height": 16,
  "rows": [
    "2222222222222222222222222222222",
    "2111111111111111111111111111112",
    "2111111111111111111111111111112",
    "2111111111111111111111111111112",
    "2111111111111111111111111111112",
    "2111111111111111111111111111112",
    "2111111111111111111111111111112",
    "2111111111111111111111111111112",
    "2111111111111113111111111111112",
    "2111111111111111111111111111112",
    "2111111111111111111111111111112",
    "2111111111111111111111111111112",
    "2111111111111111111111111111112",
    "2111111111111111111111111111112",
    "2111111111111111111111111111112",
    "2222222222222222222222222222222"
  ]
}
